VISDATA
28
0 0
1 0
2 0
3 0
4 0
5 0
6 0
7 0
8 0
9 9  10 13 14 21 16 27 26 25 24 
10 9  16 9 21 14 13 27 26 25 24 
11 0
12 0
13 9  9 21 16 10 27 26 25 14 24 
14 9  9 21 10 27 26 16 25 13 24 
15 0
16 9  10 9 27 21 13 26 25 14 24 
17 0
18 0
19 0
20 0
21 9  10 9 13 14 16 27 26 25 24 
22 0
23 0
24 9  26 25 27 16 14 13 10 9 21 
25 9  24 16 14 13 27 10 26 9 21 
26 9  24 16 14 13 10 27 25 9 21 
27 9  24 16 14 13 10 25 26 9 21 
